2	2	2	2	2	2	2	2	2	2	2	2	2	2	2	2	2	2	2	2	2	0	0	0	0	0	0	0	0	0	0	0	0	2	2	2	2	2	2	2	2	2	2	2	2	2	2	2	2	2	
2	1	1	13	13	13	1	1	1	1	13	13	13	13	13	13	13	1	13	13	2	0	0	0	0	0	0	0	0	0	0	0	0	2	3	3	13	13	13	13	13	13	13	13	13	13	13	13	13	2	
2	1	1	13	13	13	2	2	2	2	13	13	13	13	13	1	1	1	1	1	2	2	2	2	2	2	2	2	2	2	2	2	2	2	3	3	13	13	13	13	13	13	13	13	13	13	2	2	1	2	
2	13	13	13	2	2	2	13	13	2	2	13	13	13	13	13	13	1	13	13	13	13	13	13	3	3	3	3	3	3	13	13	13	2	3	3	13	2	2	13	13	13	13	13	13	13	13	2	1	2	
2	13	13	13	13	13	1	1	1	1	2	2	2	13	13	13	13	2	13	13	13	13	13	13	3	3	3	3	3	3	13	13	13	2	2	13	13	13	2	2	2	2	2	13	13	2	13	2	1	2	
2	13	2	2	2	13	1	3	3	1	13	13	2	2	13	13	13	13	13	13	13	13	13	13	2	2	2	2	2	2	13	13	13	13	2	13	13	13	13	13	13	13	2	2	13	13	13	2	1	2	
2	13	13	13	2	2	1	1	1	1	13	13	13	2	2	13	13	13	13	13	13	13	13	13	13	13	13	13	13	13	13	13	13	13	2	13	2	13	13	1	1	13	13	2	2	13	13	13	13	2	
2	13	13	13	13	2	2	2	2	13	13	13	13	13	13	13	13	13	13	2	2	2	13	13	13	13	13	13	13	13	13	13	13	13	2	13	13	13	13	13	13	13	13	13	13	13	13	13	13	2	
2	13	13	13	13	13	13	13	13	13	2	2	2	13	13	13	13	13	13	13	13	13	13	13	13	13	13	13	13	13	13	13	13	13	2	13	13	2	2	2	2	13	13	13	13	13	13	2	2	2	
2	13	3	3	3	13	13	13	13	2	2	13	13	13	13	13	13	13	13	13	13	13	13	13	13	13	13	13	13	13	13	13	13	13	2	13	13	13	13	13	2	2	2	13	13	13	13	13	13	2	
2	13	3	3	3	13	13	13	2	2	13	13	2	2	2	2	13	13	13	13	13	13	13	13	13	7	7	2	2	13	13	13	13	13	2	13	13	3	3	13	13	13	13	13	2	13	13	3	3	2	
2	13	13	13	13	13	2	2	2	13	13	13	13	13	13	13	13	13	13	13	13	2	2	13	13	2	0	0	2	2	13	13	13	13	2	13	13	13	13	13	13	13	13	13	2	13	13	13	13	2	
2	13	13	13	13	13	13	13	13	13	13	13	13	13	13	13	13	13	13	13	13	13	13	13	13	2	0	0	0	6	13	2	13	13	2	2	2	2	2	2	13	13	2	2	2	13	13	2	2	2	
7	7	7	7	7	7	7	7	7	7	7	7	7	13	13	13	2	2	2	2	2	2	2	13	13	2	2	2	6	6	13	13	13	13	13	13	13	13	13	13	13	13	13	13	13	13	13	13	13	2	
6	3	3	3	13	13	13	13	13	13	13	13	13	13	13	13	13	13	13	13	2	13	13	13	13	13	13	13	13	13	13	13	13	2	13	13	13	13	13	13	13	13	13	13	13	13	13	13	13	2	
6	6	6	6	13	13	13	13	13	13	13	13	13	2	13	13	13	13	13	13	2	13	3	3	3	13	13	13	13	13	13	13	13	13	13	13	13	13	13	13	13	13	13	13	13	2	2	13	13	2	
0	0	0	6	13	2	13	13	13	13	13	13	13	2	2	2	2	13	13	13	13	13	3	3	3	13	13	2	2	2	2	13	13	13	13	13	13	2	2	2	2	3	3	3	3	3	2	13	13	2	
2	2	6	6	13	13	13	2	13	13	13	13	2	2	13	13	13	13	13	13	13	13	13	13	13	13	13	13	13	13	13	13	2	2	2	13	13	2	0	0	2	3	3	3	3	3	2	2	2	2	
2	1	1	1	1	1	1	1	1	13	2	2	2	13	13	13	13	13	13	13	13	13	2	2	2	13	13	13	13	13	13	13	13	13	13	13	13	2	2	0	2	2	3	3	3	2	2	0	0	0	
2	1	1	1	1	1	1	1	1	2	2	13	13	13	13	13	13	13	13	13	13	13	13	13	13	13	13	13	13	13	13	13	13	13	13	13	13	13	2	0	0	2	2	2	2	2	0	0	0	0	
2	2	2	2	2	2	2	2	2	2	13	13	13	13	13	1	1	3	3	13	13	13	13	13	13	13	13	13	13	13	13	2	2	2	2	2	2	2	2	2	0	0	0	0	0	0	0	0	0	0	
2	1	1	13	13	3	3	13	13	13	13	13	2	2	2	1	1	3	3	2	2	2	13	13	13	13	13	13	13	13	13	13	13	13	13	1	1	1	1	2	0	0	0	0	0	0	0	0	0	0	
2	1	1	13	13	3	3	13	13	13	13	13	13	13	13	1	1	3	3	13	13	13	13	13	13	13	13	2	2	2	2	2	2	2	13	1	1	1	1	2	0	0	0	0	0	0	0	0	0	0	
2	2	2	13	13	13	13	13	13	13	2	2	13	13	13	13	13	13	13	13	13	13	1	1	13	2	2	2	13	13	13	13	13	13	13	1	1	1	1	2	0	0	0	0	0	0	0	0	0	0	
2	13	13	13	13	2	2	2	2	2	2	13	13	13	13	13	13	13	13	13	13	13	1	1	13	13	13	13	13	13	13	13	13	13	13	2	2	13	13	2	2	2	2	2	2	2	2	2	2	0	
2	13	13	13	13	13	13	13	13	13	13	13	13	13	13	13	2	2	2	13	13	13	13	13	13	13	13	13	13	13	13	13	13	13	13	13	13	13	13	13	13	13	13	13	13	13	13	1	2	2	
2	13	13	13	13	13	13	13	13	13	13	13	13	13	13	13	13	13	2	2	2	2	13	13	13	13	13	13	2	2	2	2	2	2	2	13	13	13	13	13	13	13	13	13	13	13	13	4	4	2	
2	3	3	13	13	13	13	3	3	3	3	13	13	13	2	13	13	13	13	13	13	2	2	2	2	2	2	2	2	13	13	13	13	13	13	13	13	5	5	13	13	13	13	13	13	13	13	4	4	2	
2	3	3	13	13	13	13	13	13	13	13	13	13	13	2	13	13	1	1	1	13	13	13	13	13	13	13	13	13	13	13	13	13	13	13	13	13	5	5	13	13	13	13	13	2	2	2	2	2	2	
2	13	13	13	13	2	2	2	2	2	2	2	2	2	2	13	13	1	1	1	13	13	13	13	13	13	13	4	4	4	13	13	13	13	13	13	2	2	2	2	2	2	2	2	2	0	0	0	0	0	
2	13	13	13	13	13	13	13	13	13	13	13	13	13	13	13	13	13	13	13	13	13	13	13	13	13	13	4	4	4	13	2	2	2	2	2	2	2	0	0	0	0	0	0	0	0	0	0	0	0	
2	13	13	13	13	13	13	13	13	13	1	13	13	13	13	13	13	2	2	2	13	13	13	13	13	13	13	13	13	13	13	13	13	13	13	13	13	2	0	0	0	0	0	0	0	0	0	0	0	0	
2	13	2	2	2	2	13	1	1	1	1	1	13	13	13	13	13	13	13	13	13	13	13	13	13	13	2	2	2	2	2	2	2	2	13	13	13	2	0	0	0	0	0	0	0	0	0	0	0	0	
2	13	13	13	13	13	13	13	13	13	1	13	13	13	13	13	13	13	13	13	13	13	13	13	13	13	13	13	13	13	13	13	13	2	2	2	13	2	0	0	0	0	0	0	0	0	0	0	0	0	
2	13	13	13	13	2	2	2	2	2	2	2	2	2	13	13	2	2	2	2	2	2	13	13	13	13	13	13	13	13	1	1	13	13	3	2	13	2	2	2	2	2	2	2	0	0	0	0	0	0	
2	13	13	13	13	13	13	1	1	1	13	13	13	13	13	13	3	3	3	3	3	3	13	13	13	13	13	13	13	13	13	13	13	13	13	2	13	13	13	13	13	13	13	2	0	0	0	0	0	0	
2	13	13	13	13	13	13	13	13	13	13	13	13	13	13	13	3	3	3	3	3	3	13	13	2	2	2	2	2	2	2	2	2	2	2	2	13	13	13	1	1	13	13	2	0	0	0	0	0	0	
2	13	13	2	2	2	13	13	13	13	13	2	2	2	2	2	3	3	3	3	3	3	13	13	13	13	13	13	13	13	13	13	13	13	13	13	13	13	1	1	1	1	13	2	2	0	0	0	0	0	
2	1	2	2	3	3	3	2	2	2	2	2	13	13	13	2	2	2	2	2	2	2	2	13	13	13	13	13	3	3	3	3	3	3	3	13	13	13	13	13	13	13	13	13	2	0	0	0	0	0	
2	1	2	3	3	3	3	2	13	13	13	13	13	13	13	13	2	2	2	2	1	1	2	13	13	13	13	13	13	13	13	13	13	13	13	13	13	2	2	13	13	13	13	13	2	0	0	0	0	0	
2	1	2	3	3	3	3	2	13	13	13	1	1	1	1	1	13	13	13	2	1	1	1	13	13	13	13	13	2	2	2	2	2	2	2	2	2	2	2	2	2	2	2	2	2	0	0	0	0	0	
2	1	2	2	3	2	2	2	13	13	13	3	3	3	3	3	13	13	13	2	2	2	1	13	2	13	13	13	2	0	0	0	0	0	0	0	0	0	0	0	0	0	0	0	0	0	0	0	0	0	
2	13	13	2	2	2	13	13	13	13	13	3	3	3	3	3	13	13	13	13	13	2	2	13	13	13	13	13	2	0	0	0	0	0	0	0	0	0	0	0	0	0	0	0	0	0	0	0	0	0	
2	13	13	13	13	13	13	13	13	13	13	1	1	1	1	1	13	13	13	13	13	13	2	13	13	13	2	13	2	0	0	0	0	0	0	0	0	0	0	0	0	0	0	0	0	0	0	0	0	0	
2	13	13	3	3	3	13	13	13	13	13	13	13	13	13	13	13	13	13	13	13	13	13	13	13	13	13	13	2	0	0	0	0	0	0	0	0	0	0	0	0	0	0	0	0	0	0	0	0	0	
2	13	3	3	3	3	3	13	13	13	13	13	13	13	13	13	13	13	13	13	13	13	13	13	2	13	13	13	2	0	0	0	0	0	0	0	0	0	0	0	0	0	0	0	0	0	0	0	0	0	
2	13	3	3	3	3	3	13	13	13	13	13	13	13	13	13	13	13	13	13	13	13	2	3	3	3	3	3	2	0	0	0	0	0	0	0	0	0	0	0	0	0	0	0	0	0	0	0	0	0	
2	13	13	3	3	3	13	13	13	13	13	13	13	13	13	13	13	13	13	13	13	2	2	2	3	3	3	2	2	0	0	0	0	0	0	0	0	0	0	0	0	0	0	0	0	0	0	0	0	0	
2	13	2	2	2	2	2	2	2	13	13	13	13	13	13	13	13	13	13	2	2	2	0	2	2	2	2	2	0	0	0	0	0	0	0	0	0	0	0	0	0	0	0	0	0	0	0	0	0	0	
2	2	2	0	0	0	0	0	2	2	2	2	2	2	2	2	2	2	2	2	0	0	0	0	0	0	0	0	0	0	0	0	0	0	0	0	0	0	0	0	0	0	0	0	0	0	0	0	0	0	
